#FileName	Species	Taxonomy
Atri_prot.fa	Amborella_trichopoda	angiosperms
Acoe_prot.fa	Aquilegia_coerulea	dicots
Atha_prot.fa	Arabidopsis_thaliana	dicots
Bole_prot.fa	Brassica_oleracea	dicots
Cpap_prot.fa	Carica_papaya	dicots
Csin_prot.fa	Citrus_sinensis	dicots
Dcar_prot.fa	Daucus_carota	dicots
Egra_prot.fa	Eucalyptus_grandis	dicots
Gmax_prot.fa	Glycine_max	dicots
Grai_prot.fa	Gossypium_raimondii	dicots
Inil_prot.fa	Ipomoea_nil	dicots
Mdom_prot.fa	Malus_domesticus	dicots
Mesc_prot.fa	Manihot_esculenta	dicots
Mgut_prot.fa	Mimulus_guttatus	dicots
Mtru_prot.fa	Medicago_truncatula	dicots
Paxi_prot.fa	Petunia_axillaris	dicots
Pper_prot.fa	Prunus_persica	dicots
Ptri_prot.fa	Populus_trichocarpa	dicots
Rcom_prot.fa	Ricinus_communis	dicots
Slyc_prot.fa	Solanum_lycopersicum	dicots
Vvin_prot.fa	Vitis_vinifera	dicots
Afil_prot.fa	Azolla_filiculoides	ferns
Scuc_prot.fa	Salvinia_cucullata	ferns
Smoe_prot.fa	Selaginella_moellendorfii	lycophytee
Bpra_prot.fa	Bathycoccus_prasinos	green_algae
Cbra_prot.fa	Chara_braunii	charophytic_green_algae
Crei_prot.fa	Chlamydomonas_reinhardtii	green_algae
Csp2_prot.fa	Coccomyxa_sp_C169	green_algae
Csp1_prot.fa	Chlorella_sp_NC64A	green_algae
Dsal_prot.fa	Dunaliella_salina	green_algae
Knit_prot.fa	Klebsormidium_nitens	charophytic_green_algae
Mpus_prot.fa	Micromonas_pusilla	green_algae
Oluc_prot.fa	Ostreococcus_lucimarinus	green_algae
Otau_prot.fa	Ostreococcus_taurii	green_algae
Vcar_prot.fa	Volvox_carteri	green_algae
Pabi_prot.fa	Picea_abies	gymnosperms
Ptae_prot.fa	Pinus_taeda	gymnosperms
Aagr_prot.fa	Anthoceros_agrestis_Oxford	hornworts
Apun_prot.fa	Anthoceros_punctatus	hornworts
Mpol_prot.fa	Marchantia_polymorpha	liverworts
Bdis_prot.fa	Brachypodium_distachyon	monocots
Macu_prot.fa	Musa_acuminata	monocots
Osat_prot.fa	Oryza_sativa	monocots
Sbic_prot.fa	Sorghum_bicolor	monocots
Sita_prot.fa	Setaria_italica	monocots
Zmay_prot.fa	Zea_mays	monocots
Ppat_prot.fa	Physcomitrella_patens	mosses
Psch_prot.fa	Pleurozium_schreberi	mosses
Sfal_prot.fa	Sphagnum_fallax	mosses
Cmer_prot.fa	Cyanidioschyzon_merolae	red_algae
Gsul_prot.fa	Galdieria_sulphuraria	red_algae
Ppur_prot.fa	Porphyridium_purpureum	red_algae
